10.ox
o...o.....
.....oooo.
..o.......
o..ooo..oo
..oo......
.o..oo.o.o
..........
ooo...o.oo
oo.....ooo
ooo.oooooo
